1. Глаголы

Глаголы Наличия
Be - Быть
Have - Иметь
There Is - Имеется

Глаголы Положения
Put - Ставить
Lay - Положить
Lie - Лежать
Sit - Сидеть
Sit Down - Садиться
Stand - Стоять / Ставить
Hang - Висеть / Вешать

Бытовые Глаголы
Live - Жить
Be Born - Родиться
Work - Работать
Earn - Зарабатывать
Eat - Есть
Drink - Пить
Bake - Печь
Fry - Жарить
Boil - Кипятить /кипеть
Wear - Носить
Put On - Надевать
Wash - Стирать
Iron - Гладить
Go To Bed - Ложиться Спать
Sleep - Спать

Глаголы Чувства
Love - Любить
Like - Нравиться
Want - Хотеть
Prefer - Предпочитать
Admire - Восхищаться
Hate - Ненавидеть
Accuse - Обвинять
Suffer - Страдать
Cry - Плакать
Smile - Улыбаться
Laugh - Смеяться
Enjoy - Наслаждаться
Doubt - Сомневаться
Hurt - Делать Больно
Offend - Обижать

Глаголы Мышления
See - Видеть
Look - Смотреть
Listen - Слушать
Hear - Слышать
Feel - Чувствовать
Remember - Помнить
Forget - Забывать
Recognize - Узнавать
Read - Читать
Write - Писать
Count - Считать
Add - Прибавлять
Subtract - Вычитать
Multiply - Умножать
Divide - Делить
Think - Думать
Decide - Решать

Рабочие Операции
Do - Делать
Make - Делать
Perform - Выполнять
Prepare - Готовить
Hide - Прятать
Search - Искать
FInd - Находить
Add - Добавлять
FIll - Наполнять
Reduce - Сокращать
Exclude - Исключать
Spend - Тратить
Spoil - Портить
Remain - Оставаться
Keep - Удерживать
Possess - Владеть
Belong - Принадлежать
Take - Брать
Keep - Держать
Push - Толкать
Pull - Тянуть
Throw - Бросать
Open - Открывать
Shut - Закрывать
Cut - Резать
Pour - Лить
Dry - Сушить
Begin - Начинать(ся)
Appear - Появляться
Continue - Продолжать(ся)
Take - Занимать (время)

Глаголы Общения
Speak - Говорить
Talk - Говорить
Say - Сказать
Tell - Сказать
Address - Обращаться
Ask - Спрашивать / Просить
Answer - Отвечать
Allow - Разрешать
Prohibit - Запрещать
Advise - Советовать
Warn - Предупреждать
Suggest - Предлагать
Give - Давать
Offer - Предлагать
Buy - Покупать
Sell - Продавать
Borrow - Брать Взаймы
Lend - Одолжить
Introduce - Представлять
Disturb - Мешать / Беспокоить
Forgive - Прощать
Apologize - Извиняться

Глаголы Противостояния
Attack - Нападать
Fight - Сражаться
Defend - Защищать
Win - Победить /выиграть
Lose - Проигрывать
Shoot - Стрелять
Kill - Убить
Wound - Ранить