4. Наречия

Вопросительные
How - Как
How Many - Сколько
How Much - Сколько
Where - Где
Когда - When
Почему - Why

Места
Where - Где
Here - Здесь
There - Там
Somewhere - Где-нибудь
Anywhere - Где-нибудь
Everywhere - Везде
Nowhere - Нигде
Inside - Внутри
Outside - Снаружи
Beside - Рядом
Above - Наверху
Below - Внизу
In Front Of - Впереди
Ahead - Впереди / Вперед
Behind - Сзади
High - Высоко
Low - Низко
Far - Далеко
Near - Близко

Направления
Назад - Back, Backwards
Вперед - Ahead, Towards
Up - Вверх
Down - Вниз
Sideways - В Сторону
Направо - To The Right
Налево - To The Left
Вокруг - Around

Времени
Now - Сейчас
Lately - В Последнее Время
Recently - Недавно
Just - Только Что
On The Eve - Накануне
Once - Однажды
Before - Раньше
Long Ago - Давно
Then - Тогда
Afterwards - После
Immediately - Немедленно
Soon - Скоро
Today - Сегодня
Tonight - Сегодня Вечером
Tomorrow - Завтра
The Day After Tomorrow - Послезавтра
Yesterday - Вчера
The Day Before Yesterday - Позавчера
Still - Все Еще
Already - Уже
Yet - Уже

Повторения И Частотности
Always - Всегда
Often - Часто
Frequently - Часто
Constantly - Постоянно
Usually - Обычно
Seldom - Редко
Sometimes - Иногда
Never - Никогда

Наречия Для Соединения Предложений
Поэтому - That’s Why
Однако - However
Тем Не Менее - Nevertheless
Тем Временем - Meanwhile
В Противном Случае - Otherwise